12 10
0 0 0 0 0 0 0 0 0 2
0 3 0 0 0 0 0 0 0 0
0 0 0 0 0 0 0 0 0 0
0 0 0 1 1 1 1 0 0 1
0 0 0 1 0 0 0 0 0 2
0 0 0 0 0 0 0 0 0 0
0 0 0 0 0 0 0 0 0 0
0 0 0 1 0 0 0 0 0 0
0 0 0 1 2 0 0 0 0 0
0 0 0 1 0 0 0 0 0 0
1 1 0 1 0 0 0 0 0 0
2 0 0 1 0 0 0 0 0 0
4 8 6 9
7 5 8 6