18 22
0 0 0 0 0 0 0 0 0 0 0 0 0 0 0 0 0 0 1 1 1 0
0 0 0 0 0 0 0 1 1 1 1 0 0 0 0 0 1 1 1 0 0 0
0 0 0 0 3 0 0 1 1 1 1 1 0 0 0 0 1 0 0 0 1 0
0 0 0 0 0 0 0 1 0 0 0 1 0 0 1 0 1 0 1 1 1 0
0 0 0 0 0 0 0 1 0 1 0 1 0 0 1 1 1 0 1 0 0 0
0 0 0 0 0 0 0 1 0 1 0 1 1 1 1 0 1 0 1 0 1 0
0 0 0 0 0 0 0 1 0 1 0 0 0 0 0 0 0 0 1 1 1 0
0 0 0 0 0 0 0 1 1 1 0 1 1 1 1 1 1 1 1 0 1 0
0 0 0 0 0 0 0 0 0 0 0 1 0 0 0 0 0 0 0 0 0 0
0 0 0 0 0 0 0 1 1 1 1 1 0 1 1 1 1 1 1 1 1 1
0 0 0 0 0 1 1 1 2 0 0 0 0 0 0 0 0 0 0 0 0 0
0 0 0 0 0 0 1 0 0 0 0 0 0 0 0 0 0 0 0 0 0 0
1 1 1 1 1 0 0 0 0 0 0 0 0 0 0 0 0 0 0 0 0 0
1 0 0 0 1 1 0 1 0 0 0 0 0 0 0 0 0 0 0 0 0 0
1 0 1 0 1 1 0 1 0 0 0 0 2 0 0 0 0 0 1 1 1 0
1 0 1 0 0 0 0 1 0 0 0 0 0 0 0 0 0 0 1 2 1 0
1 0 1 0 0 0 0 1 0 0 0 0 0 0 0 0 0 0 1 0 1 0
2 0 1 0 0 0 0 1 0 0 0 0 0 0 0 0 0 0 1 0 0 0
14 12 14 15
15 12 17 12